 wwwww   
 w   wwww
 w   w  w
 ww cb gw
www wwwgw
w b w wgw
w b w www
w   w    
wwwww    